1 15 25
#########################
#p    **o *  ow*o* m   q#
# # #* # 1#*  #*#  # #  #
#     f *2 *s   2b      #
#     o  *wh**   *w*    #
# *1b* *w   **o* **x* * #
# # # # # *#1 #*  # #  ##
#       *     * **o *   #
#b#* #f1# # #   #s # #*##
#* bf   o** b*   2b **  #
#*w  ***s* *m* w**2* *  #
#1# wx#w# * # *#mo#* #  #
#fmf  ** s     * mb* *  #
#1#o*#w #o*#* #   # #*o##
#########################
