1 15 25
#########################
#p   *  *m*m** *   *   q#
# #  #  # # # b*#**m#   #
#    * m    *           #
#     **  *b1 f  mos    #
#h#*b#o# #  s#**o#m w#*##
#* * h   *m* **** b* *w #
#*  m1  w * m*   fm    f#
# h * h*fh***o b *h ho x#
#*# *# # ms#ww# *s#w#* ##
#*hfh   b  h*    * *m*  #
#*#* s#*  #**h# b2# # * #
# b*f h2*   ***    *1o*o#
#h# #  #h*#2 *# # *w# #*#
#########################
