5 15 25
#########################
#p   m  w1*x*     hf   q#
# #  #*s#w#* # *#1#   # #
#          ****swo *    #
#    * mm** 1 **1 *     #
#*#*m# w*# #2* #**# *h# #
#     * f *  sm*ho  o** #
#* 1*2  2 hsf*o   f    *#
#o w1 m  s* m*     * b *#
#*# # *#*  #h*#w*#*o#b# #
#s*   o  *f**    *   b  #
#*#*# * #*m#o#* *#*#s# *#
#1*wfo*  * f**  f **o***#
#    ** ***s**s  * s****#
#########################
