2 13 31
###############################
#p     * sf f   b     *  *  f #
# # #*# # #s# #s# #x# # # # # #
#       *f* b   b  s        bf#
# # # # # # #2#1# # # # #2# # #
#bs* 2*b b   **        * *2f  #
# #f# #*# #f#b# #*# #*# #s# # #
#s f*   b    f   f*   bfs     #
# # # # # # # # #1# # # #f#f# #
#  bs  s   *   *    sb    fs  #
# # # # #f#*#s#*#b#*# # # # #s#
#* f**f  b s   2        f *f  #
###############################
