1 13 31
###############################
#p  b f * bf     2*  * *      #
# # # # # #*# # # # #f# # # #f#
#  *   b       bs* *  b   s * #
# #*#*# # # # # # # # # # # #s#
#      * f            b  b*s2 #
#s# # # # #b#b#f#2# # #*# # # #
#     b    s *  f    b 1  ss  #
# # # #b# # # # #f# # # #x# # #
#          * 1b   *b   f*  b f#
# # # # # # # # # #*#s# #s#f#f#
#      1  s**   s     b   b  b#
###############################
