4 15 25
#########################
#p   bf  m **w*  ***   q#
# #  # w #b #* w# #*# # #
#     **  * o *w   m    #
# # #w# *# # * # #** # ##
# *w   w w w * * ***** *#
#o  m1mw     * *   xb  w#
#   *o*hb2*1 f*s*o  *   #
#*# #* *#   #*#*# *# #f*#
#  o***w**o m   1  *   h#
#*# s#*s # #*#  #2w #* *#
# w* h*m 2s1**2 ***bf* o#
#*w*fh b **f ***o* *2 *o#
# # *#  m#  f# *#*#  # *#
#########################
