2 15 25
#########################
#p    f*  * *2h  1 *   q#
# #  #*#*#s#m #b*#* # # #
#    h   wf *  ****o    #
#     s * m* *h*  2     #
# # #   #**#b  #**#*#1#*#
#b**    *  s  o  s * s* #
# hm  soo    f** o  s * #
# # *#w 1# #* m# m*#h s##
# *   h so1****  m**   w#
#    w m*  bw h** ***o* #
#h# o#* m#s #* # #* #  *#
#f h***m w *x * * s *h  #
#   * **  1b*  * * h*ww #
#########################
