3 15 25
#########################
#p   ** ** ** s  * o   q#
# #  #   # #3#   #*# #  #
#     *1  *f *x    w    #
#      s *   ***** s    #
#w m o**    o*o*  f* h *#
#s# #*1#*o# #3*#2w# # #*#
#*  *  * *   *  *  **  m#
#*o*x  2ms4 *  * * *o  b#
#   m*  o * w f b23w *  #
# #  #  #  #w3h#h#* #b *#
#o12  ** o *o    s  *b m#
#**s * *s *4f   * *  f o#
# # x*w*#*s#  #*4  # * ##
#########################
