5 15 25
#########################
#p   oo****s*** f*w    q#
# # #   #  *#   #*#   # #
#    mh **s*fo *   *    #
# # # *2#*f #*3*# # #   #
# * *m  m * sh1*4*2s *  #
# f*s * b w *fx*s b4* os#
#2# #s4  b#  w# #3*#*x#*#
# *  * *    *o w *    f #
#h*   f  *2*f**1  o**h* #
# # #fx*s # 2#*2*# #  # #
# **s*f*  s**s* 4**3w   #
#5#*b3#*# b #5 *#*1f# *##
#**  * * ** f  **  **  *#
#########################
