1 15 25
#########################
#p   b   *s*m*    b*   q#
# # #1#m* #*h# hb# #  # #
#     *  f* *s*   **    #
# #  #s*# *#  # #* # # ##
#**  ms    *  ** *f*  * #
# # *# 1 #f #  1#* x#oh #
#*mosb*s*****  ***m  *w #
#  mmbo** w  *   o f*   #
# #1  # *m# m# om#** # o#
#b  s   w m   **  * *   #
#*so f* mbh* h *11  * *f#
#s#h# *#***#**#*#s# # *h#
#b m **bm **wm    f   *h#
#########################
