3 13 31
###############################
#p    f  s2      *** s *s   s #
# # #*# # # #*# # # # # # # #b#
#         f    s *   b f  b b2#
# # # # # #*# # #b# # #s#s# # #
#b 1s   *    s    *   2s   ff*#
# # # # #*# #*# #*#b#*#*#f# # #
# ss     *f b    *   *  b  s  #
# #1#b#f#2#s# # #x# #*# #f# #s#
#b *b b f   b  1   f*  fb *sff#
# #b# #b# #s#s# # #f# # #*#*# #
#1 *  * s     *bf***   * fs  s#
###############################
