3 13 31
###############################
#p    fbb   *b*1x  f  s *  f* #
# # # #s#s# #b# # # # #*#*#f# #
#        f    fss  s f  fb    #
# # # # # # # #*# # # # # #*# #
#      1*f f     bf      * *b2#
# # # #f# #f# # # # # #1# # # #
# s        2*2b*  *   f*s  b *#
# # #s#f# #*# # # # # # # #*# #
#*  *  f  f 2  *    b f ss   f#
# # # #b# # #f#*# # #2# # # # #
#b  b*    *     b ** s  *     #
###############################
