1 15 25
#########################
#p       b  f  f       q#
# # # #  #2 #* # b# s# ##
#    b ** 2   sf        #
#   fb  1s   ff b1 b    #
# fs   s*    *fbsb *f  s#
#*#  # * # #  #b  # #s ##
# *f   s  *bfs*    *s s #
# # #  #  #f# *#*# #   ##
# s *    *       **s    #
# #   #* # b# b#   # # *#
#     b  s   2b  s    x*#
#*  2 b s* b* f b      b#
#sf  s b*   *  s   b    #
#########################
