4 15 25
#########################
#p  s b   b   ff       q#
# # # # 2 # * #* # *f#  #
#   *  2s2* *   * s     #
# #  #   #fx#  s# #  f# #
#f    bfffb   * sf 2b  *#
# # # #*# * # #2 #   # ##
# * b  * f * s   b* f   #
#2*bsb  f     * f*   * *#
# #f*f#*  #  #*  #  *# s#
#s    2b  b b sbb   *b b#
#*#  #  # f # * #  #1 2##
#* b     b ss *     *   #
# #  *# s #s #f# #  #* ##
#########################
