3 19 17
#################
#p h* 1  s f*ss #
# #  # s # # #* #
#    f  *      s#
# s *  f * b*f  #
#*1  *   s2  * s#
# #   #f*# #b#b##
#   b  *b    *  #
#    *b  f *   f#
#2bb s bs       #
# #  #  #*b# * ##
#  f x b        #
#  s  **bf *fs  #
# # #  #* #f 1# #
#b     *  b2f  *#
# #  # # *b#  #b#
#* b2     f* f 2#
# #   #  #  f# ##
#################
