2 15 25
#########################
#  w    * *x *hso    *  #
# #  *# # # #5xs#** #*# #
# *  hm  * ** *5 ** xsw*#
# # m#s  # # #  *# #*hx##
#    ***xx        bb* *b#
#*# # # # #  *#o w# b#*##
#   **w  * *15 o*  * *h #
#f#* #m #* b#  #*  # *# #
#x m*   ****    s*f w*  #
#m *  **m****   ohs x  w#
#om   1 * *5w*s o   *   #
# #* #h#*m#s#** #*o#**pq#
#    *     * *xmx f2    #
#########################
