3 11 15
###############
#     x 1*** q#
# # #1*#*o#   #
#1m         **#
# **m1**o o**m#
#x*  **ff  m3 #
#*#  f#w  #3**#
# m* *  w*m  *#
#  x*1 m  3o  #
#     * w   p #
###############
