5 15 25
#########################
#p     h** ** fmo **   q#
# #   #**#  *#   # #   ##
#     1  *h b*b  2m     #
# #   #m  # f2#   # # # #
# **1  h* b*   1 *fb *ff#
#o#* #  #*o # * #bw#  # #
#   o  * ***w*2*  ** *  #
#*#b#*  #*#*  #*m*# #m *#
#ms * *x     2*2o*   *2 #
#1#* #  #  m#oo# **# #**#
#* *   **  *  ho  ***   #
#**   * *ms f h*m*** om #
#s  ** h s  * s* * s *  #
#########################
