1 11 11
###########
#p    xsfb#
# # # # #b#
#    1  f*#
# # # # # #
#    *bsb #
# #b#s# # #
#2   *2   #
#1#*# #b# #
#  *2*  1f#
###########
