5 15 25
#########################
#p    b1**b *** *  b   q#
# #   #* *#2 # #bs #  # #
#    * b*    b *s***    #
#    ** *b**f* f*  *    #
#f# b #f*f# #* #ff*#*2 ##
#***f1f*** * **b   * **s#
# s*1 bbssx****f * *s   #
#*#*s #*b#* *#  #b#b#*#s#
#  * **  b * s* 2*f s f*#
# *   * *  *1** *  b  **#
# #b1#  #s#f #b#  #**# b#
#  b* s1b1b  **   b**s b#
#f  * **f *   f* *** b**#
#########################
