1 11 15
###############
#p   *  *    q#
# # #*  #  #  #
#    bh  *    #
#    * 2      #
#*#x#1*# # *# #
#*mbhw*s *  **#
# om 2*** f1bm#
#* 2 o ** o b #
# #bw#2  # #  #
###############
