1 15 25
#########################
#p   *b *    b    f *  q#
# # #b # f #s#b#1  #   ##
#     *s  f b           #
# # #  # # #*#   # #  # #
# ff   b       1       s#
#ffb  fs1s      xb f s  #
# f s           fb  b *s#
# # b#b  # #f#*s #  #  f#
# ss * f  2* s *   b   s#
# * **sf  **s  fb  **  *#
# #s # **#   # # *# #f ##
#   * f    2b*    f  * *#
# # b # # # #s2# # #   ##
#########################
