5 15 25
#########################
#p  b  *b*b**f fsfsf   q#
# #  #   # * #* *# #   ##
#   *b  * s   b   *     #
#s*    fb * ss * f*s sb #
# #f*s#b*# # # #*# s# #2#
#* *bs ff   1f       s 1#
# #b 1# #  # ff#*  #f#  #
#    * fb * * * *      *#
# #   #*# f #*  #  #2# ##
#   s  bs   f sf        #
#bb   sb 2   s*    b *2 #
# # #*# # #  #*# 1f#2#b*#
#   *b2f    * xf  *  *  #
#########################
