2 13 31
###############################
#p       b  x ss  b* sb  **   #
# #2# # #s# # # #s# # #f# # # #
#       *s b   s*   s *f   s*b#
# # #s#*# # # # #s#b# #b#*# #f#
#b*     s  ssb  *sbs2*  f     #
#f# # # # #*# #*# #s# # #f# # #
# *fs   f        *       *  * #
#b# # # # # # # # #*# #b#1#*# #
#*       *   s  2  f  sss     #
#b# # # # #*# # # # # # # # # #
#* *   s    f11 *  s     fb f2#
###############################
