5 13 31
###############################
#p   b*f  b* *bf      b 2   fb#
# # #b# # # # # # #b# # #*# # #
#        * b*b2**  s *  b    f#
# # # # # # # # # # # #*# #f# #
# b    1  *  ff f   s  *sf  s #
# #*# # #*# # # # #b# # #*#f# #
# *   *  s   b   s*   *  1*s  #
#2# # #b# #*# # # #s#s#f#f# # #
#  b**f  ss  *  fs      *  ** #
# #1# # #s# #2#x#*# # # #1# #*#
#  *   2   f  b   * *s *2 bffb#
###############################
