4 15 25
#########################
#p    *** * wf*b*  h   q#
# #   # **#  #  # #w #m*#
#        ** f** b**m    #
#    **1*w**  *         #
#s*  *1m * *   1m *  2 *#
# # h*#*#sx2#  #s# #s#*##
#4   w* *  s f* *mb   * #
# *f*m1s*w*     s     2*#
#w   *b     h4x4so*   * #
# #* # o# #x 2#m#* *#* 3#
#   f * * 4* 3**m* w** s#
# b  *  * *4*h**  *2ho*s#
#s#3w #* # #*  # #**#* h#
#########################
