4 13 31
###############################
#p   1bb  s   b **    b  **b2 #
# # # # # # # # #*# #s# # # # #
#      * f  bf   * 1   *f  sbs#
# # #b# # #*# # # #f# # #f# # #
# fb *  *    1fb      s**     #
# # # #s# #*# # #s#*#1# # # # #
#  f*  * 2   b   s  s12    b f#
# #*#s#*# #s# #b#s# #f# #s# # #
#*  *      s  *b      *  *x  q#
# # # #s#*# #*#*# # # #s# # #s#
#   f b s  sf*  *  s      1   #
###############################
