3 13 31
###############################
#p    * * b  * *1         *f *#
# # # #s# # #*# # #s# #2# # # #
#      *             b      *b#
# # # #b# #2# #1# #s# # # #*#f#
#    f   **      *    s b *   #
# # # # # # # # # # # #*#f# # #
#    b *   bf b fb 1 b      s #
# # # # #*# #b#b# #b# #f#b#*# #
#   b  x      b1*ffb*b   s    #
# #b#s#*#*# #*# # #b#*# #s# # #
#bs  fs f 2 2f    * b  s * * f#
###############################
