2 15 25
#########################
#p     *h * *    w*    q#
# # #b #w #*# # * #  #  #
#      x*       bw*     #
# #   #* m#*#  #w2#**# ##
# * b **mf  f** *    s*o#
#f2s  * 1*bo  * w f  ***#
#f#  # w #1 #* #  #*  # #
#s w * m1   m* *    3 * #
# * *b * * 1 * **s* *2* #
#*#*3*#* # 1#*m # #*#* *#
#    * w * w     *   b2w#
#2  *    *m *f*  b* *   #
# # #* #  o# #*#2  #  h##
#########################
